%%%%%
% P %
% . %
% G %
%%%%%
