%%%%%%%%%%
%   .G   %
%        %
%%.   .%%%
%    P   %
%        %
%        %
%%%%%%%%%%