%%%%%%%%%%%%
%          %
% ..   ..  %
%          %
%%    P    %
% G . .    %
%          %
%     ..   %
%%%%%%%%%%%%
