%%%%%%%%%%
%.% % % .%
%%%  .   %
%    G . %
%. . %.%.%
%   .  %.%
%  .  .P%%
%..  . %.%
% %  . . %
%%%%%%%%%%