%%%%%%%%%%
%  %  .  %
%   .  . %
%  .% .  %
%      % %
%% .    %%
%    %%G %
%..% P %%%
%   .   %%
%%%%%%%%%%