%%%%%%%%%%
%   .... %
%.%  . .P%
%%..     %
% ....   %
%.   G  .%
%. %  % %%
%.%%....%%
%.    .. %
%%%%%%%%%%