%%%%%%%%%%
%    .. P%
% . .  G %
% .     %%
%   %  ..%
%   .%. %%
%.    .  %
% . . .  %
% %%     %
%%%%%%%%%%