%%%%%%%%%%
%   % % %%
%.%.  . %%
% % .    %
%%   % % %
%. .%  . %
%P %    %%
%   . .  %
%  %    G%
%%%%%%%%%%