%%%%%%%%%%
%G P    .%
%%%%%%%%%%
