%%%%%%%
%%%.%%%
%  G  %
%% P %%
%%%%%%%
