%%%%%%%
% %.% %
% %G% %
% % % %
%%%P%%%
%%%%%%%
