%%%%%%%%%%
%.     GP%
%%%%%%%%%%
