%%%%%%%%%%%%%%%%%%%%%%%%%%%%%%
%.      % % %              %.%
%       % % %%%%%% %%%%%%% % %
%       %        %     % %   %
%%%%% %%%%% %%% %% %%%%% % %%%
%   % % % %   %    %     %   %
% %%% % % % %%%%%%%% %%% %%% %
%       %     %%     % % %   %
%%% % %%%%%%% %%%% %%% % % % %
% %           %%     %    o% %
% % %%%%% % %%%% % %%% %%% % %
%   %     %      % %   % %%% %
%.  %P%%%%%      % %%% %    .%
%%%%%%%%%%%%%% %%%%%%%%%%%%%%%
%.      % % %              %.%
%       % % %%%%%% %%%%%%% % %
%       %        %     % %   %
%%%%% %%%%% %%% %% %%%%% % %%%
%   % % % %   %    %     %   %
% %%% % % % %%%%%%%% %%% %%% %
%       %     %%     % % %   %
%%% % %%%%%%% %%%% %%% % % % %
% %           %%     %    o% %
% % %%%%% % %%%% % %%% %%% % %
%   %     %      % %   % %%% %
%.  % %%%%%      % %%% %    .%
%%%%%%%%%%%%%%%%%%%%%%%%%%%%%%
